11111111111111111111
10000000000000000001
10000000000000000001
10002020203030303001
10000000000000000001
100000000N0000001001
10000000000000001001
10000000000000001001
10000000000001111001
10000000000000000001
10000000000000000001
10000000000000000001
11111111111111111111