11111111111111111111
10000000000000000001
10010001111000000001
10010000001000000001
10011110001000010001
1000000000000N010001
10000000001000010001
10011110001000000001
10010000001111110001
10000000000000000001
11111111111111111111