NO textures/greystone.xpm
SO textures/bluestone.xpm
WE textures/purplestone.xpm
EA textures/redbrick.xpm

F 255, 255, 0
C 0, 255,0

111111111111111111111111111111111
100000000000000000000000000000001
100000000000000000000000000000001
1000000000000000S0000000000000001
100000000000000000000000000000001
100000000000000000000000000000001
100000000000000000000000000000001
111111111111111111111111111111111