WE textures/greystone.xpm
SO textures/bluestone.xpm
EA textures/purplestone.xpm
NO textures/eagle.xpm


F 255, 255, 0
C 0, 255,0

111111111111111111111111111
100000000000000000000000001
100000000000000000000000001
10000000000S000000000000001
100000000000000000000000001
100000000000000000000000001
100000000000000000000000001
111111111111111111111111111