111111111111111111111111111
100000000000000000000000001
100000000010000001000000001
100000000010000001000000001
100000000010000001000000001
10000000001000000N000000001
100000000010000000000000001
100000000010000001000000001
100000000010000001000000001
100000000000000000000000001
111111111111111111111111111