NO textures/greystone.xpm
SO textures/bluestone.xpm
WE textures/purplestone.xpm
EA textures/redbrick.xpm

F 0, 255, 0
C 255,255,0

11111111111111111111
10000000000000000001
10010001111000000001
10010000001000000001
100100000000N0000001
10000000000000000001
10010000000000010001
10011100000000000001
10010000001111110001
10000000000000000001
11111111111111111111