111111111111111
100000000000001
100000000010001
100000000010001
100000000010001
1000000000100N1
100000000010001
100000000010001
100000000010001
100000000000001
111111111111111