NO
SO 
WE 
EA 
F 220,100,0
C 225,30,0


111111111111111111111111111111111
111100001000000000110000000000001
    10001011000000110000000000011
111111101001000000000000000000001
111111101011000001110000000000001
100000000011000001110111111111111
11110111111111011100000010001
11110111111111011101000000001
11000000110101011101111111111
1000000001000000110001   101
1000000001000000110111   101
100000N0001000000110001  101
11000001110101011111011111011
11110111 1110101 101000000001
11111111 1111111 111111111111

