111111111111111111111
100001000000000000001
10100000000000000000111111
10000010010010010010000001
10000000N00000000000111111
100000101010000000001
111111111111111111111
